{
  "layers": [
    {
      "data": [
        0, -1, -1, -1, 3, 3, 3, -1, -1, -1, -1, -1, -1, -1, -1, -1, -1, -1, -1, -1, -1, -1, -1, -1, -1, -1, -1, -1, -1, -1, -1, -1,
        -1, -1, 3, -1, 3, -1, 3, -1, 3, 3, 3, -1, -1, -1, -1, -1, -1, -1, 3, 3, 3, -1, -1, -1, -1, -1, -1, -1, -1, -1, -1, -1,
        -1, -1, 3, -1, -1, -1, 3, -1, -1, -1, 3, -1, -1, -1, -1, -1, -1, -1, 3, -1, 3, -1, -1, -1, -1, -1, -1, -1, -1, -1, -1, -1,
        -1, -1, 3, -1, 3, -1, 3, -1, -1, -1, 3, -1, -1, -1, -1, -1, -1, -1, 3, -1, 3, -1, -1, -1, -1, -1, -1, -1, -1, -1, -1, -1,
        -1, -1, 3, -1, 3, -1, 3, -1, -1, -1, 3, -1, -1, -1, -1, -1, -1, -1, 3, -1, 3, -1, -1, -1, 3, 3, 3, 3, 3, 3, -1, -1,
        -1, -1, -1, -1, 3, -1, -1, -1, -1, -1, 3, -1, -1, -1, -1, -1, -1, -1, 3, -1, 3, -1, -1, -1, -1, -1, -1, -1, -1, 3, -1, -1,
        -1, -1, -1, -1, 3, 3, 3, 3, 3, 3, 3, -1, -1, -1, -1, -1, -1, -1, -1, -1, 3, -1, -1, -1, -1, -1, -1, -1, -1, 3, -1, -1,
        -1, -1, -1, -1, -1, -1, -1, -1, -1, -1, -1, -1, -1, -1, 3, 3, 3, -1, -1, -1, 3, -1, -1, -1, -1, -1, -1, -1, -1, 3, -1, -1,
        -1, -1, -1, -1, -1, -1, -1, -1, -1, -1, -1, -1, -1, -1, 3, -1, 3, -1, -1, -1, 3, -1, -1, -1, -1, -1, -1, -1, -1, 3, -1, -1,
        -1, -1, 3, 3, 3, 3, 3, -1, -1, -1, -1, -1, -1, -1, 3, -1, 3, -1, -1, -1, 3, -1, -1, -1, 3, 3, 3, 3, 3, 3, -1, -1,
        -1, -1, 3, -1, -1, -1, 3, -1, -1, -1, -1, -1, -1, -1, 3, -1, 3, -1, -1, -1, 3, -1, -1, -1, -1, -1, -1, -1, -1, -1, -1, -1,
        -1, -1, 3, -1, -1, -1, 3, -1, -1, -1, -1, -1, -1, -1, -1, -1, 3, -1, -1, -1, 3, -1, -1, -1, -1, -1, -1, -1, -1, -1, -1, -1,
        -1, -1, 3, -1, -1, -1, 3, -1, -1, -1, -1, -1, -1, -1, -1, -1, 3, -1, -1, -1, 3, -1, -1, -1, -1, -1, -1, -1, -1, -1, -1, -1,
        -1, -1, 3, -1, -1, -1, -1, -1, -1, -1, 3, 3, 3, -1, -1, -1, 3, -1, -1, -1, 3, -1, -1, -1, -1, -1, -1, -1, -1, -1, -1, -1,
        -1, -1, 3, -1, -1, -1, -1, -1, -1, -1, 3, -1, 3, -1, -1, -1, 3, -1, -1, -1, 3, -1, -1, -1, 3, 3, 3, 3, 3, -1, -1, -1,
        -1, -1, 3, -1, -1, -1, -1, -1, -1, -1, 3, -1, 3, -1, -1, -1, 3, -1, -1, -1, 3, -1, -1, -1, -1, -1, -1, -1, 3, -1, -1, -1,
        -1, -1, 3, 3, 3, 3, 3, 3, 3, 3, 3, -1, 3, -1, -1, -1, -1, -1, -1, -1, 3, -1, -1, -1, -1, -1, -1, -1, 3, -1, -1, -1,
        -1, -1, -1, -1, -1, -1, -1, -1, -1, -1, -1, -1, 3, -1, -1, -1, -1, -1, -1, -1, 3, -1, -1, -1, -1, -1, -1, -1, 3, -1, -1, -1,
        -1, -1, -1, -1, -1, -1, -1, -1, -1, -1, -1, -1, 3, -1, -1, -1, -1, -1, -1, -1, 3, -1, -1, -1, -1, -1, -1, -1, 3, -1, -1, -1,
        -1, -1, -1, -1, -1, -1, -1, -1, -1, -1, -1, -1, 3, 3, 3, 3, 3, 3, 3, 3, 3, -1, -1, -1, 3, 3, 3, 3, 3, -1, -1, -1,
        -1, -1, -1, -1, -1, -1, -1, -1, -1, -1, -1, -1, -1, -1, -1, -1, -1, -1, -1, -1, -1, -1, -1, -1, -1, -1, -1, -1, -1, -1, -1, -1,
        -1, -1, 3, 3, 3, 3, 3, 3, 3, -1, -1, -1, -1, -1, -1, -1, -1, -1, -1, -1, -1, -1, -1, -1, -1, -1, -1, -1, -1, -1, -1, -1,
        -1, -1, -1, -1, -1, -1, -1, -1, 3, -1, -1, -1, -1, -1, -1, -1, -1, -1, -1, -1, -1, -1, -1, -1, -1, -1, -1, -1, -1, -1, -1, -1,
        -1, -1, -1, -1, -1, -1, -1, -1, 3, -1, -1, -1, -1, -1, -1, -1, -1, -1, 3, 3, 3, 3, 3, -1, -1, -1, -1, -1, -1, -1, -1, -1,
        -1, -1, -1, -1, -1, -1, -1, -1, 3, -1, -1, -1, -1, -1, -1, -1, -1, -1, -1, -1, -1, -1, 3, -1, -1, -1, -1, -1, -1, -1, -1, -1,
        -1, -1, -1, -1, -1, -1, -1, -1, 3, -1, -1, -1, -1, -1, -1, -1, -1, -1, -1, -1, -1, -1, 3, -1, -1, -1, -1, -1, -1, -1, -1, -1,
        -1, -1, -1, -1, -1, -1, -1, -1, 3, -1, -1, -1, -1, -1, -1, -1, -1, -1, -1, -1, -1, -1, 3, -1, -1, -1, -1, -1, -1, -1, -1, -1,
        -1, -1, -1, -1, -1, -1, -1, -1, 3, 3, 3, 3, 3, 3, 3, 3, 3, 3, 3, 3, 3, 3, 3, -1, -1, -1, -1, -1, -1, -1, -1, -1,
        -1, -1, -1, -1, -1, -1, -1, -1, -1, -1, -1, -1, -1, -1, -1, -1, -1, -1, -1, -1, -1, -1, -1, -1, -1, -1, -1, -1, -1, -1, -1, -1,
        -1, -1, -1, -1, -1, -1, -1, -1, -1, -1, -1, -1, -1, -1, -1, -1, -1, -1, -1, -1, -1, -1, -1, -1, -1, -1, -1, -1, -1, -1, -1, -1,
        -1, -1, -1, -1, -1, -1, -1, -1, -1, -1, -1, -1, -1, -1, -1, -1, -1, -1, -1, -1, -1, -1, -1, -1, -1, -1, -1, -1, -1, -1, -1, -1,
        -1, -1, -1, -1, -1, -1, -1, -1, -1, -1, -1, -1, -1, -1, -1, -1, -1, -1, -1, -1, -1, -1, -1, -1, -1, -1, -1, -1, -1, -1, -1, 8
      ],
      "height": 32,
      "width": 32
    }
  ]
}
